Grapheme	IPA
$	NULL
►	NULL
-	+
oʔo	o.ʔ.o
uʔu	u.ʔ.u
aʔa	a.ʔ.a
əʔə	ə.ʔ.ə
hʲ	hʲ
pʲ	pʲ
kʲ	kʲ
mʲ	mʲ
wʲ	wʲ
jʲ	jʲ
dz	dz
ə	ə
ts	ts
tʃ	tʃ
ɲ	ɲ
ə:	ə:
i:	i:
a:	a:
e:	e:
u:	u:
o:	o:
k	k
l	l
a	a
j	j
h	h
m	m
u	u
n	n
w	w
i	i
t	t
o	o
p	p
e	e
s	s
ʔ	ʔ
d	d
g	g
ʃ	ʃ
b	b
r	r
x	x
ŋ	ŋ
